{
  "tileSize": 16,
  "width": 15,
  "height": 25,
  "rows": [
    "WWWWWWWWWWWWWWW",
    "WWWWWWWWWWWWWWW",
    "WWWSSSSSSSWWWWW",
    "WWSSGGGGGSSWWWW",
    "WSSGGGGGGGSSWWW",
    "WSSGGGGGGGSSWWW",
    "WSSGGGGGGGSSWWW",
    "WSSGGTTTGGSSWWW",
    "WSSGGTTTGGSSWWW",
    "WSSGGTTTGGSSWWW",
    "WSSGGGGGGGSSWWW",
    "WSSGGGGGGGSSWWW",
    "WSSGGGGGGGSSWWW",
    "WSSGGGGGGGSSWWW",
    "WSSGGGGGGGSSWWW",
    "WSSGGGGGGGSSWWW",
    "WSSGGGGGGGSSWWW",
    "WSSGGGGGGGSSWWW",
    "WSSGGGGGGGSSWWW",
    "WWSDDDDDDSWWWWW",
    "WWSDDDDDDSWWWWW",
    "WWSSSSSSSSWWWWW",
    "WWWWWWWWWWWWWWW",
    "WWWWWWWWWWWWWWW",
    "WWWWWWWWWWWWWWW"
  ]
}
