{
  "tileSize": 16,
  "width": 15,
  "height": 25,
  "rows": [
    "WWWWWWWWWWWWWWW",
    "WWWWWWWWWWWWWWW",
    "WWSSSSSSSSSWWWW",
    "WSSGGGGGGGGSSWW",
    "WSSGGGGGGGGSSWW",
    "WSSGGCCCGGGSSWW",
    "WSSGGCMCGGGSSWW",
    "WSSGGCCCGGGSSWW",
    "WSSGGGMGGGGSWWW",
    "WSSGGGGGGGGSSWW",
    "WSSGGGGGGGGSSWW",
    "WSSGGMGGMGGSSWW",
    "WSSGGGGGGGGSSWW",
    "WSSGGGGGGGGSSWW",
    "WSSGMGGGGGGSSWW",
    "WSSGGGGGGGGSSWW",
    "WSSGGGGGGGGSSWW",
    "WSSGGGGGGGGSSWW",
    "WWSDDDDDDDSWWWW",
    "WWSDDDDDDDSWWWW",
    "WWSSSSSSSSSWWWW",
    "WWWWWWWWWWWWWWW",
    "WWWWWWWWWWWWWWW",
    "WWWWWWWWWWWWWWW",
    "WWWWWWWWWWWWWWW"
  ]
}
