{
  "tileSize": 16,
  "width": 15,
  "height": 25,
  "rows": [
    "WWWWWWWWWWWWWWW",
    "WWWWWWWWWWWWWWW",
    "WWSSSSSSSSSSWWW",
    "WSSGGPPPGGGSSWW",
    "WSSGGPPPGGGSSWW",
    "WSSGGPPPGGGSSWW",
    "WSSGGGGGGGGSSWW",
    "WSSGGGGGGGGSSWW",
    "WSSGGGGGGGGSSWW",
    "WSSGGGGGGGGSSWW",
    "WSSGGGGGGGGSSWW",
    "WSSGGGGGGGGSSWW",
    "WSSGGGGGGGGSSWW",
    "WSSGGGGGGGGSSWW",
    "WSSGGGGGGGGSSWW",
    "WSSGGGGGGGGSSWW",
    "WSSGGGGGGGGSSWW",
    "WWSDDDDDDDSWWWW",
    "WWSDDDDDDDSWWWW",
    "WWSSSSSSSSSWWWW",
    "WWWWWWWWWWWWWWW",
    "WWWWWWWWWWWWWWW",
    "WWWWWWWWWWWWWWW",
    "WWWWWWWWWWWWWWW",
    "WWWWWWWWWWWWWWW"
  ]
}
